                                       #########################################################################################################################
                                       #                                                                                                                       #
                                       #                                                                                                                       #
                                       #                                                                                                                       #
                                       #                                                                                                                       #
                                       #                                                                                                                       #
                                       #                                                                                                                       #
                                       #                                                                                                                       #
                                       #                                                                                                                       #
                                       #                                                                                                                       #
                                       #                                                                                                                       #
                                       #                                                                                                                       #
                                       #                                                                                                                       #
                                       #                                                                                                                       #
                                       #                                                                                                                       #
                                       #                                                                                                                       #
                                       #                                                                                                                       #
                                       #                                                                                                                       #
                                       #          ##             ##    #############         ##          ##                                                    #
                                       #           ##           ##     ##         ##         ##          ##                                                    #
                                       #            ###        ##      ##         ##         ##          ##                                                    #
                                       #              ##     ##        ##         ##         ##          ##                                                    #
                                       #                ##  ##         ##         ##         ##          ##                                                    #
                                       #                  ##           ##         ##         ##          ##                                                    #
                                       #                  ##           ##         ##         ##          ##                                                    #
                                       #                  ##           ##         ##         ##          ##                                                    #
                                       #                  ##           ##         ##         ##          ##                                                    #
                                       #                  ##           #############         ##############                                                    #
                                       #                                                                                                                       #
                                       #                                                                                                                       #
                                       #                                                                                                                       #
                                       #                                                                                                                       #
                                       #                                                                                                                       #
                                       #                                                                                                                       #
                                       #                                                                                                                       #
                                       #                                                                                                                       #
                                       #                                                                                                                       #
                                       #                                                                                                                       #
                                       #                                                                                                                       #
                                       ##########################################################################################################################


