################################################################################################################################################################
##                                                                                                                    ##                                      ##
##                                                                                                                    ##                                      ##
##                                                                                                                    ##                                      ##
##                                                                                                                    ##                                      ##
##                                                                                                                    ##                                      ##
##                                                                                                                    ##                                      ##
##                                                                                                                    ##                                      ##
##                                                                                                                    ##                                      ##
##                                                                                                                    ##                                      ##
##                                                                                                                    ##                                      ##
##                                                                                                                    ##                                      ##
##                                                                                                                    ##                                      ##
##                                                                                                                    ##                                      ##
##                                                                                                                    ##                                      ##
##                                                                                                                    ##                                      ##
##                                                                                                                    ##                                      ##
##                                                                                                                    ##                                      ##
##         ###             ###   #############         ##          ##                                                 ##                                      ##
##          ###           ###    ##         ##         ##          ##                                                 ##                                      ##
##            ###        ###     ##         ##         ##          ##                                                 ##                                      ##
##               ###  ###        ##         ##         ##          ##                                                 ##                                      ##
##                  ##           ##         ##         ##          ##                                                 ##                                      ##
##                  ##           ##         ##         ##          ##                                                 ##                                      ##
##                  ##           ##         ##         ##          ##                                                 ##                                      ##
##                  ##           #############         ##############                                                 ##                                      ##
##                                                                                                                    ##                                      ##
##                                                                                                                    ##                                      ##
##                                                                                                                    ##                                      ##
##                                                                                                                    ##                                      ##
##                                                                                                                    ##                                      ##
##                                                                                                                    ##                                      ##
##                                                                                                                    ##                                      ##
##                                                                                                                    ##                                      ##
##                                                                                                                    ##                                      ##
##                                                                                                                    ##                                      ##
##                                                                                                                    ##                                      ##
##                                                                                                                    ##                                      ##
##                                                                                                                    ##                                      ##
################################################################################################################################################################