################################################################################################################################################################
##                                                                                                                    ##                                      ##
##                                                                                                                    ##                                      ##
##                                                                                                                    ##                                      ##
##                                                                                                                    ##                                      ##
##                                                                                                                    ##                                      ##
##                                                                                                                    ##                                      ##
##                                                                                                                    ##                                      ##
##                                                                                                                    ##                                      ##
##                                                                                                                    ##                                      ##
##                                                                                                                    ##                                      ##
##                                                                                                                    ##                                      ##
##                                                                                                                    ##                                      ##
##                                                                                                                    ##                                      ##
##                                                                                                                    ##                                      ##
##                                                                                                                    ##                                      ##
##                                                                                                                    ##                                      ##
##                                                                                                                    ##                                      ##
##          ##             ##    #############         ##          ##                                                 ##                                      ##
##           ##           ##     ##         ##         ##          ##                                                 ##                                      ##
##            ###        ##      ##         ##         ##          ##                                                 ##                                      ##
##                ##  ##         ##         ##         ##          ##                                                 ##                                      ##
##                  ##           ##         ##         ##          ##                                                 ##                                      ##
##                  ##           ##         ##         ##          ##                                                 ##                                      ##
##                  ##           ##         ##         ##          ##                                                 ##                                      ##
##                  ##           #############         ##############                                                 ##                                      ##
##                                                                                                                    ##                                      ##
##                                                                                                                    ##                                      ##
##                                                                                                                    ##                                      ##
##                                                                                                                    ##                                      ##
##                                                                                                                    ##                                      ##
##                                                                                                                    ##                                      ##
##                                                                                                                    ##                                      ##
##                                                                                                                    ##                                      ##
##                                                                                                                    ##                                      ##
##                                                                                                                    ##                                      ##
##                                                                                                                    ##                                      ##
##                                                                                                                    ##                                      ##
##                                                                                                                    ##                                      ##
################################################################################################################################################################